8
9
   ##### 
  ##   ##
  #     #
###B#B# #
#  X X  #
# #XPX# #
#  T T  #
#########