8
9
    #####
#####   #
#PTTXBB #
# BBXTT #
##  # ###
 #     # 
 ###   # 
   ##### 