8
9
    #####
#####   #
#PTT BB #
# BB TT #
##  # ###
 #     # 
 ###   # 
   ##### 