9
9
####     
#  #     
#  ##### 
#  BTB ##
## TXT P#
#  BTB# #
#  ##   #
#  ######
####     