8
8
  ##### 
###   # 
# B # ##
# #  T #
#    # #
## #   #
 #P  ###
 #####  