8
8
  ##### 
###   # 
# B # ##
# #  T #
#    # #
##B#T  #
 #P  ###
 #####  