10
8
  ####
  #  ##
###BT ##
#  TB  #
# #BT  #
# #TB ##
#P#BT##
# #  #
#    #
######