6
6
##### 
#P  ##
#TBX #
#  # #
#    #
######