9
11
#####      
#   #######
# PB      #
## BT#### #
 # BXB  # #
 ## TTT # #
  #  # ## #
  ####    #
     ######