6
7
###### 
#P   ##
# BB  #
# #T T#
#     #
#######