8
9
  ######
  #P#  #
###BB  ##
#  TXB  #
#   TX# #
#### T  #
   #  ###
   ####