8
8
  ##### 
###   # 
# B # ##
# #  T #
# T  # #
##B#TB #
 #P  ###
 #####  