10
8
   ####
   #  #
 ###  ##
 #  B  #
## #B#P#
# TTXTT#
#   B  #
####B ##
   #  #
   ####