6
8
######  
#    ###
#   TT #
# BBBP #
#  # T #
########