10
8
 ####
 #P #
##TB###
# TB  ##
# BT#  #
##BT   #
# TB#  #
# TB  ##
#  ####
####
