10
10
   ######
  ##    #
###  ## ##
# TTT #  #
# BBB ##P#
### #  # #
  # BBB# #
  # TTT  #
  ###   ##
    #####