9
9
    ####
  ###  #
###    ##
#  T#T  #
# #X+X  #
#  BBB ##
## # ###
 #   #
 #####