8
8
########
#  #   #
#   B  #
#  #BB #
## #   #
#TT B# #
#TT   P#
########