9
7
#####
#   ##
#    ##
##TBT #
##TBT #
# BTB #
#PBTB #
###  ##
  ####