10
9
    ####
    #  #
  ###  #
### BT ##
#  T  B #
# #B #T #
# # TBP##
# ### ##
#     #
#######