8
11
 ########  
 # P#   #  
 # B  B #  
 #B #######
## B#     #
#T T T    #
#T  #######
#####