9
9
     ####
#### #  #
#  ###BT#
#    BT #
#  #BT  #
## BT ###
 #BT P#  
 #  ###  
 ####    