9
9
  ####   
 ##  ### 
## BT  ##
# BTBT  #
# #BTBT #
#P# BT  #
# ##  ###
#    ##  
######   