8
8
    ####
#####  #
#      #
# B #T #
##XXXX##
# TP B #
#      #
########
