10
9
   ####
 ###  ##
 #  B  #
 #  X# ##
##TXPXT #
#  #X   #
#   B ###
#  #  #
####  #
   ####