8
10
 ########
##  P   #
#   ### #
# BTBTBT##
##BTBTBT #
 # ## #  #
 #      ##
 ########