9
9
  #####  
 ##   ###
##  #   #
#  TXB# #
# #XPX  #
#  BXT ##
####  ## 
   #  #  
   ####  