8
11
     ####
 #####  #
 #      #
## #TTT ###
# BBB#BBB #
#  #T+T   #
#    #  ###
#########