9
10
   ####
 ###  #
 #  T ##
## #T  ###
#PBBXTT  #
#   B  # #
####B### #
   #     #
   #######